"C(5,1)","34"
"C(5,0)","33"
"O(4,4)","32"
"C(4,0)","30"
"O(3,2)","12"
"O(5,5)","35"
"O(1,3)","11"
"O(2,1)","3"
"O(3,4)","8"
"C(2,1)","26"
"O(5,1)","7"
"O(2,5)","6"
"O(4,2)","15"
"O(4,1)","5"
"O(3,5)","9"
"O(2,4)","4"
"O(5,4)","20"
"O(3,1)","2"
"O(4,5)","10"
"C(1,0)","21"
"O(2,3)","1"
"O(1,4)","14"
"O(1,5)","16"
"O(5,2)","17"
"C(4,1)","31"
"C(1,1)","23"
"C(3,1)","28"
"O(1,2)","13"
"O(4,3)","18"
"O(5,3)","19"
"C(3,0)","27"
"O(1,1)","22"
"C(2,0)","24"
"O(3,3)","29"
"O(2,2)","25"
